###########
#.........#
#.........#
#.........#
#...@.....#
#.........#
#.........#
#.........#
#.........#
#.........#
###########