###########
#.........#
#.........#
#.#....#..#
#.#.@..#..#
#.#....#..#
#.#....#..#
#.#....#..#
#.#....#..#
#.........#
###########