###########
##........#
#.....#...#
#..#.#....#
#...#.....#
#.........#
#.....#.#.#
#.....#...#
#......#..#
#@......#.#
###########