###########
#...#.....#
#.#.#.#.#.#
#.#.#.#.#.#
#.#.#.#.#.#
#.#.#.#.#.#
#.#.#.#.#.#
#.#.#.#.#.#
#.#.#####.#
#@#.......#
###########