###########
#...#.....#
#.#.#.#.#.#
#.#.#...#.#
#...#.#.#.#
#.#...#.#.#
#.#.#.#.#.#
#.#.#.#.#.#
#...#####.#
#@#.......#
###########