###########
#.........#
#..#####..#
#.........#
#.#.@..#..#
#.#....#..#
#.#....#..#
#.........#
#..#####..#
#.........#
###########