###########
#...#.....#
#.#...#.#.#
#.#.#...#.#
#...#.#.#.#
#.#...#.#.#
#.#.#.#.#.#
#.#.#...#.#
#...#.###.#
#@........#
###########