###########
##........#
#.#...#...#
#..#.#....#
#...#.....#
#.........#
#.....###.#
#.....#...#
#......#..#
#@......#.#
###########